boolean_expressions.json			_
causal_judgement.json	How would a typical person answer each of the following questions about causation?\n	prefix	_
date_understanding.json	 in MM/DD/YYYY	middle	_
disambiguation_qa.json	In the following sentences, explain the antecedent of the pronoun (which thing the pronoun refers to), or state that it is ambiguous.\n	prefix	_
dyck_languages.json	Complete the rest of the sequence, making sure that the parentheses are closed properly.	prefix	_
formal_fallacies.json	_
geometric_shapes.json	 draws a	suffix	_
hyperbaton.json	Which sentence has the correct adjective order:\n	prefix	_
logical_deduction_five_objects.json	The following paragraphs each describe a set of five objects arranged in a fixed order. The statements are logically consistent within each paragraph.	prefix	_
logical_deduction_seven_objects.json	The following paragraphs each describe a set of seven objects arranged in a fixed order. The statements are logically consistent within each paragraph.	prefix	_
logical_deduction_three_objects.json	The following paragraphs each describe a set of three objects arranged in a fixed order. The statements are logically consistent within each paragraph.	prefix	_
movie_recommendation.json	Find a movie similar to 	prefix	_
multistep_arithmetic_two.json			_
navigate.json	If you follow these instructions, do you return to the starting point?	prefix	_
object_counting.json	How many	suffix_re	_
penguins_in_a_table.json	Here is a table where the first line is a header and each subsequent line is a penguin:	prefix	_
reasoning_about_colored_objects.json			_
ruin_names.json	Which of the following is a humorous edit of this artist or movie name: 	prefix	_
salient_translation_error_detection.json	The following translations from German to English contain a particular error. That error will be one of the following types: Named Entities: An entity (names, places, locations, etc.) is changed to a different entity. Numerical Values: Numerical values (ordinals or cardinals), dates, and/or units are changed. Modifiers or Adjectives: The modifiers and adjectives pertaining to a noun are changed. Negation or Antonyms: Introduce or remove a negation or change comparatives to their antonyms. Facts: Trivial factual errors not pertaining to the above classes are introduced in the translations. Dropped Content: A significant clause in the translation is removed. Please identify that error.	prefix	_
snarks.json	Which statement is sarcastic?\nOptions:\n	prefix	_
sports_understanding.json	Is the following sentence plausible?	prefix	_
temporal_sequences.json	We know that:	prefix_re	_
tracking_shuffled_objects_five_objects.json	:	prefix_re	_
tracking_shuffled_objects_seven_objects.json	:	prefix_re	_
tracking_shuffled_objects_three_objects.json	:	prefix_re	_
web_of_lies.json			_
word_sorting.json	Sort the following words alphabetically:	prefix	_